5 1 1 1 1 1 1 1 1 7 0 0 0 5 1 1 1 7 
4 0 0 0 0 0 0 0 0 14 0 0 0 13 0 0 0 3 
4 0 0 0 0 0 0 0 0 14 0 0 0 9 0 0 0 3 
4 0 0 0 0 0 0 0 0 14 0 0 9 0 0 0 0 3 
4 0 0 0 0 0 0 0 0 14 0 9 0 0 0 0 0 8 
4 0 0 0 0 0 0 0 0 11 9 0 0 0 0 10 0 0 
4 0 0 0 0 0 0 0 0 0 13 0 0 0 0 13 0 0 
4 0 0 0 0 0 0 0 0 0 13 0 0 0 0 9 0 0 
6 10 0 0 0 0 0 0 0 0 13 0 0 0 0 0 10 0 
0 13 0 0 0 0 10 0 0 0 13 0 0 0 0 0 13 7 
0 13 0 0 0 0 13 0 0 0 13 0 0 0 0 0 13 3 
0 13 0 0 0 0 13 0 0 0 13 0 0 0 0 0 0 3 
5 9 0 0 0 0 9 0 0 0 9 0 0 0 0 0 0 3 
4 0 0 0 0 0 0 0 0 0 0 0 0 0 0 0 0 3 
4 0 0 0 10 0 0 0 10 0 0 0 0 0 0 0 0 3 
4 0 0 0 13 0 0 0 13 0 0 0 13 0 0 0 0 3 
4 0 0 0 9 0 0 0 9 0 0 0 0 0 0 0 0 3 
4 0 0 0 0 0 0 0 0 0 0 0 0 0 0 0 0 3 
4 0 0 0 0 0 0 0 0 0 0 0 0 0 0 0 0 3 
6 16 10 0 0 0 0 0 0 0 0 0 0 0 0 0 0 3 
0 0 13 0 0 0 0 0 0 0 0 0 0 0 0 0 0 3 
0 0 13 0 0 0 0 0 0 0 0 0 0 0 0 0 0 3 
0 0 13 0 0 0 0 0 0 0 0 0 0 0 0 0 0 3 
5 15 9 0 0 0 0 0 0 0 0 0 0 0 0 0 0 3 
4 0 0 0 0 0 0 0 0 0 0 0 0 0 0 0 0 3 
4 0 0 0 0 0 0 0 0 0 0 0 0 0 0 0 0 3 
4 0 0 0 0 0 0 0 0 0 0 12 16 10 0 0 0 3 
4 0 0 0 0 0 0 0 0 0 0 14 0 13 0 0 0 3 
4 0 0 0 0 0 0 0 0 0 0 14 0 13 0 0 0 3 
6 16 10 0 0 0 0 0 0 0 0 14 0 13 0 0 0 3 
0 0 13 0 0 0 0 0 0 0 0 14 0 13 0 0 0 3 
0 0 6 2 2 2 2 2 2 2 2 8 0 6 2 2 2 8 
